###################################################
#......#..........................................#
#......#..........................................#
#...>.<#..........................................#
#2.....#..........................................#
####d###.........................................<#
#....#............................................#
#....#............................................#
#....d............................................#
######............................................#
#.......................................###########
#.......................................#........<#
#.......................................#.#..#....#
#.......................................#.#####...#
#.......................................#....#....#
#.......................................#....#....#
#.......................................#.........#
###################################################
