###################################################
#......#.................................##########
#......#..............................#<.##########
#..>..<#..............................#############
#......#............................###############
####d###............................#>SSS........<#
#....#..............................###############
#....#............................................#
#....d............................................#
######..................................###########
#.......................................#........<#
#.......................................#.#####...#
#.......................................#.....#...#
#.......................................#.#####...#
#.......................................#.....#...#
#.......................................#.#####...#
#.......................................#.........#
###################################################
